-h      Print this helpful message to stout and exit.
-d      Pretty print (display) the maze after reading.  (Default: off)
-s      Print shortest solution steps.                  (Default: off)
-p      print an optimal path.                          (Default: off)
-i INFILE       Read maze from INFILE.                  (Default: stdin)
-o OUTFILE      Write all output to OUTFILE.            (Default: stdout)
 |------------------------------------------------------------| 
  . . . . . . # . . # . . . # . . . # # # . . . # . . # # # # | 
 |. . . # . . . . # # . # # # # . . . . # # # # . . # . . . # | 
 |. # . . # . # . # . # . # . . . . . # . # . . . . . . # . # | 
 |# . # . # . . # . . . # . . . . . # . # . . . . . # . . # . | 
 |. # . # . . # # # . . # . . # . . . . . . # . # . # . . . # | 
 |# . . . . . . # . # # . # . . # # . # # . # . # . . . # # # | 
 |. . # # . # . . . # . # . . # . . . # . # # # # # . . # # . | 
 |. . . . # . . . # . # # . # . . . # # # # # . . . . # . . . | 
 |# # . . . . . # # . . . . . . # . . # # . . . # . . # # # . | 
 |# # # # # # . # . # # . . . # . # . . . # # . . . . . . . # | 
 |. # . # . . . # . # # . . . . # . # . . # # # # . # . . . . | 
 |. . # . . . . . # . . . . . . # # . # # # . # # . # . . # . | 
 |# . # . # . . . . . . . . . # . . . # # # . # . . . . # # . | 
 |. # . . # . . . # # . . . . # . # . . # . . . . # # . . # . | 
 |. # # . . # . # . # . . . . . . # # # . . # # . . . . # # # | 
 |# . . # # # . # . . . . . . . # . . # # # . . . # # . # . # | 
 |. # . # . # . . . . # . . # # # # # . . . . . . . . . # # . | 
 |# . . # # . . # . # # # . # . # # . # # . # # . . . . . . . | 
 |# . . . # . . . # # # . . . . . . # . . . . . # # . . . . . | 
 |# . . . # . . # . . . . # . . . . . . # . . . . . # . # . . 
 |------------------------------------------------------------| 
Solution in 54 steps.
 |------------------------------------------------------------| 
  . + + + + + # . . # . . . # . . . # # # . . . # . . # # # # | 
 |. . . # . + . . # # . # # # # . . . . # # # # . . # . . . # | 
 |. # . . # + # . # . # . # . . . . . # . # . . . . . . # . # | 
 |# . # . # + . # . . . # . . . . . # . # . . . . . # . . # . | 
 |. # . # . + # # # . . # . . # . . . . . . # . # . # . . . # | 
 |# . . . . + + # . # # . # . . # # . # # . # . # . . . # # # | 
 |. . # # . # + . . # . # . . # . . . # . # # # # # . . # # . | 
 |. . . . # . + . # . # # . # . . . # # # # # . . . . # . . . | 
 |# # . . . . + # # . . . . . . # . . # # . . . # . . # # # . | 
 |# # # # # # + # . # # . . . # . # . . . # # . . . . . . . # | 
 |. # . # . . + # . # # . . . . # . # . . # # # # . # . . . . | 
 |. . # . . . + + # . . . . . . # # . # # # . # # . # . . # . | 
 |# . # . # . . + + + + + + . # . . . # # # . # . . . . # # . | 
 |. # . . # . . . # # . . + . # . # . . # . . . . # # . . # . | 
 |. # # . . # . # . # . . + . . . # # # . . # # . . . . # # # | 
 |# . . # # # . # . . . . + . . # . . # # # . . . # # . # . # | 
 |. # . # . # . . . . # . + # # # # # . . + + + + + + + # # . | 
 |# . . # # . . # . # # # + # . # # . # # + # # . . . + + + + | 
 |# . . . # . . . # # # . + + + + + # + + + . . # # . . . . + | 
 |# . . . # . . # . . . . # . . . + + + # . . . . . # . # . + 
 |------------------------------------------------------------| 
